SO ./textures/30.png
F  42,231,0

EA ./textures/31.png

C 255,0,0
NO ./textures/32.png
WE ./textures/33.png


        1111111111111111111111111
        1000000000110000000000001
        1011000001110000000000001
        1001000000000000000000001
111111111011000001110000000000001
100000000011000001110111110111111
11110111111111011100000010001
11110111111111011101010010001
11000000110101011100000010001
10000000000000001100000010001
10000000000000000110101001001
11000001110101011111011110N0111
11110111 1110101 101111010001
11111111 1111111 111111111111
111111111111111111
110000000000000011
11111111111111