SO ./textures/PNGS/1.png
F  42,231,0

EA ./textures/PNGS/10.png

C      0,98,241
NO ./textures/PNGS/30.png
WE ./textures/PNGS/46.png

11111111111
10000000001
10000000001
10100000101
10010001001
10000N00001
10010001001
10100000101
10000100001
10000000001
11111111111