SO ./textures/SUR.png
F  42,231,0

EA ./textures/ESTE.png

C      0,98,241
NO ./textures/NORTE.png
WE ./textures/OESTE.png


111111111111
1100000111111111
10010E001111
10000001111111
11111111111
1111111
100011111111
1111111111111
 