SO ./textures/SUR.png
F  42,231,0

EA ./textures/ESTE.png

C      0,98,241
NO ./textures/NORTE.png
WE ./textures/OESTE.png

111111111111
111111111111
110000000011
110000000011
110000000011
110000000011
11000E000011
110000000011
110000000011
110000000011
110000000011
111111111111
111111111111