SO ./textures/SUR.png
F  42,231,0

EA ./textures/ESTE.png

C      0,98,241
NO ./textures/NORTE.png
WE ./textures/OESTE.png

111111111111
111111111111
110000000011
111111111111
100000000001
100000000001
10000E000001
100000000001
100000000001
111111111111
110000000011
111111111111
111111111111