SO ./perrete.png
F 220,100,0

EA ./perrete.png

C      225,30,0
NO ./perrete.png
WE ./perrete.png


1
111111
100S1
111111