SO ./perrete.png
F  42,231,0

EA ./perrete.png

C      0,98,241
NO ./perrete.png
WE ./perrete.png



111111111
10000000111
111111111
 
111111
100S11111111
1111111111111
 